"a" = (/obj/effect/landmark/map_data{height = 2; name = "Map Data"},/turf/space,/area/space)
"b" = (/turf/space,/area/space)
"c" = (/turf/simulated/wall/r_wall,/area/space)
"d" = (/turf/simulated/floor/tiled/dark,/area/space)
"e" = (/obj/structure/ladder/updown,/turf/simulated/floor/tiled/dark,/area/space)
"f" = (/turf/simulated/wall/r_wall/hull,/area/space)
"g" = (/turf/simulated/floor/plating,/area/space)
"h" = (/obj/machinery/airlock_sensor/airlock_exterior,/turf/simulated/wall/r_wall/hull,/area/space)
"i" = (/obj/machinery/door/airlock/external,/turf/simulated/floor/plating,/area/space)
"j" = (/obj/machinery/airlock_sensor/airlock_interior,/turf/simulated/wall/r_wall/hull,/area/space)
"k" = (/obj/machinery/door/airlock/multi_tile/maintenance,/turf/simulated/floor/tiled/dark,/area/space)
"l" = (/obj/machinery/door/airlock/multi_tile/medical,/turf/simulated/floor/tiled/dark,/area/space)
"m" = (/obj/structure/catwalk,/turf/simulated/floor/plating,/area/space)
"n" = (/obj/effect/catwalk_plated/dark,/turf/space,/area/space)
"o" = (/obj/machinery/alarm,/turf/simulated/wall/r_wall,/area/space)
"p" = (/obj/machinery/firealarm,/turf/simulated/wall/r_wall,/area/space)
"q" = (/obj/effect/floor_decal/unn/l1,/turf/simulated/floor/tiled/dark,/area/space)
"r" = (/obj/effect/floor_decal/unn/l2,/turf/simulated/floor/tiled/dark,/area/space)
"s" = (/obj/effect/floor_decal/unn/l3,/turf/simulated/floor/tiled/dark,/area/space)
"t" = (/obj/effect/floor_decal/unn/l4,/turf/simulated/floor/tiled/dark,/area/space)
"u" = (/obj/effect/floor_decal/unn/l5,/turf/simulated/floor/tiled/dark,/area/space)
"v" = (/obj/effect/floor_decal/unn/l6,/turf/simulated/floor/tiled/dark,/area/space)
"w" = (/obj/effect/floor_decal/unn/l7,/turf/simulated/floor/tiled/dark,/area/space)
"x" = (/obj/effect/floor_decal/unn/l8,/turf/simulated/floor/tiled/dark,/area/space)
"y" = (/obj/effect/floor_decal/unn/l9,/turf/simulated/floor/tiled/dark,/area/space)

(1,1,1) = {"
bbbbbbbbbbbbbbbbbbbbbbbbbbbbbbbbbbbbbbbb
bbbbbbbbbbbbbbbbbbbbbbbbbbbbbbbbbbbbbbbb
bbbbbbbbbbbbbbbbbbbbbbbbbbbbbbbbbbbbbbbb
bbbbbbbbbbbbbbbbbbbbbbbbbbbbbbbbbbbbbbbb
bbbbbbbbbbbbbbbbbbbbbbbbbbbbbbbbbbbbbbbb
bbbbbbbbbbbbbbbbbbbbbbbbbbbbbbbbbbbbbbbb
bbbbbbbbbbbbbbbbbbbbbbbbbbbbbbbbbbbbbbbb
bbbbbbbbbbbbbbbbbbbbbbbbbbbbbbbbbbbbbbbb
bbbbbbbbbbbbbbbbbbbbbbbbbbbbbbbbbbbbbbbb
bbbbbbbbbbbbbbbbbbbbbbbbbbbbbbbbbbbbbbbb
abbbbbbbbbbbbbbbbbbbbbbbbbbbbbbbbbbbbbbb
bbbbbbbbbbnmmmmmhifmmhifmmmmmnbbbbbbbbbb
bbbbbbbbbbmffffffgjfffgjfffffmbbbbbbbbbb
bbbbbbbbbbffgggccicccciccgggffbbbbbbbbbb
bbbbbbbbbbfggggcggggggggcggggfbbbbbbbbbb
bbbbbbbbbbfggggcgddddddgcggggfbbbbbbbbbb
bbbbbbbbbbfggggcgddddddgcggggfbbbbbbbbbb
bbbbbbbbbbfggggcgddddddgcggggfbbbbbbbbbb
bbbbbbbbbbfggggcgddddddgcggggfbbbbbbbbbb
bbbbbbbbbbfggggcgddddddgcggggfbbbbbbbbbb
bbbbbbbbbbfggggcgddddddgcggggfbbbbbbbbbb
bbbbbbbbbbfggggcggggggggcggggfbbbbbbbbbb
bbbbbbbffffggggcccckdccccggggffffbbbbbbb
bbbbbbbfgggggggggcddddcgggggggggfbbbbbbb
bbbbbbbfgggggggggcddddcgggggggggfbbbbbbb
bbbbbbbfggcccccccocddcpcccccccggfbbbbbbb
bbbbbbbfggcdddcdcddddddcdddddcggfbbbbbbb
bbbbbbbfggcdddcccddddddcdddddcggfbbbbbbb
bbbbbbbfggcdddddcddddddcdddddcggfbbbbbbb
bbbbbbbfggcdddddcddddddcdddddcggfbbbbbbb
bbbbbbbfggcdddcccddddddcdddddcggfbbbbbbb
bbbbbbbfggcdddcdcdeddedcdddddcggfbbbbbbb
bbbbbbbffgcccccccccldcccccccccgffbbbbbbb
bbbbbbbbfggcddddddddddddddddcggfbbbbbbbb
bbbbbbbbffgcddddddqrsdddddddcgffbbbbbbbb
bbbbbbbbbfgcddddddtuvdddddddcgfbbbbbbbbb
bbbbbbbbbfgcddddddwxydddddddcgfbbbbbbbbb
bbbbbbbbbfgcddddddddddddddddcgfbbbbbbbbb
bbbbbbbbbfgcddddddddddddddddcgfbbbbbbbbb
bbbbbbbbbfgcddddddddddddddddcgfbbbbbbbbb
bbbbbbbbbfgcddddddddddddddddcgfbbbbbbbbb
bbbbbbbbbfgcccccdddddddddccccgfbbbbbbbbb
bbbbbbbbbfgggggcccccccccccggggfbbbbbbbbb
bbbbbbbbbfffggggggggggggggggfffbbbbbbbbb
bbbbbbbbbbbffffffffffffffffffbbbbbbbbbbb
bbbbbbbbbbbbbbbbbbbbbbbbbbbbbbbbbbbbbbbb
bbbbbbbbbbbbbbbbbbbbbbbbbbbbbbbbbbbbbbbb
bbbbbbbbbbbbbbbbbbbbbbbbbbbbbbbbbbbbbbbb
bbbbbbbbbbbbbbbbbbbbbbbbbbbbbbbbbbbbbbbb
bbbbbbbbbbbbbbbbbbbbbbbbbbbbbbbbbbbbbbbb
"}
